####################
 ########### ###############################
    ########################################
 ## ##     ######            ###############
### ## ### ###### ##########################
### ## ### ## ### ##########################
###    ### ######            ###############
########## ###### ##########################
########## ######            ###############
##########        ########## ###############
########## #################                
####       ######################### #######
########## ####### ################# #######
################## ################# #######
##  ##############   #######################
############################################
