####################
 ########### ###############################
    ########################################
 ## ##     ######            ###############
### ## ### ###### #################
### ## ### ## ### ##########################
###    ### ######            ###############
########## ###### ##########################
########## ######            ###############
##########        ########## ###############
########## #################                
####       ######################### #######
########## ####### #########   ##### #######
########## ######## #########   ##### ######
##  ###### ########   #######   ############
############################################
######
