####################
 ########### ###############################
    ########################################
 ## ##     ######            ###############
### ## ### ###### #################
### ## ### ## ### ##########################
###    ### ######            ###############
########## ###### ##########################
########## ######            ###############
##########        ########## ###############
########## #################                
####       ######################### #######
########## ####### #########   ##### #######
################## #########   ##### #######
##  ##############   #######   #############
############################################
