############################################
    ########################################
### ##     ######            ###############
### ## ### ###### ##########################
### ## ### ###### ##########################
###    ### ######            ###############
########## ###### ##########################
########## ######            ###############
##########        ########## ###############
########## #################                
####       ######################### #######
########## ######################### #######
#################################### #######
############################################
############################################
