##################################
 #################################
             #
 ########### # ###################
############   #####################
###################fasa############
####a#####################gg########
######d###
##########
